background_1.png
________________________________________________________________________________
________________________________________________________________________________
________________________________________________________________________________
__________#_____________________________________________________________________
________________________________________________________________________________
__________#___________________________________________________##________________
____________________##__________________________________________________________
_____###_____##__________###_________________###___________##___________________
________________________________________________________________________________
___##___###_________________###____________##___###_______________#_____________
______________###_____________________________________###_______________________
___________________________________________________________________________E____
#______#############______##############________________________________########
#_____###############_____##############________________________________########
########################################________________________________########