background_1.png
____________________________________________________________
____________________________________________________________
____________________________________________________________
__________#_________________________________________________
____________________________________________________________
__________#_________________________________________________
____________________##______________________________________
_____###_____##__________###_________________###____________
____________________________________________________________
___##___###_________________###____________##___###_________
______________###_____________________________________###___
____________________________________________________________
####################______##############____________________
#####################_____##############____________________
########################################____________________