____________________
____________________
____________________
__________#_________
____________________
__________#_________
____________________
_____###_____##_____
____________________
___##___###_________
______________###___
____________________
####################
####################
####################